111111111111111111111111111111
1E000000000000C000000000000001
10000000000000000000000000C001
100000000000000000000000000001
10000000000C000000000000000C01
100C00000000000C00000000000001
1P0000000000000000000000000001
100000000C00000000C00000000001
10000000000000000000000C000001
111111111111111111111111111111