111111111111111111111111111111
1P00000000000000000000000000E1
1000000000000000000000C0000011
111111111111111111111111111111