1111111111111111111111
1C0000CCCC00000000C111
1000101000000001C00111
1P001E100000000CCCC011
1111111111111111111111