1111111111111111111111111111
1E000000000A000C00000C000001
1010010100100000101001000001
101P010010101010001001000001
1010010010101010001001000001
1111111111111111111111111111