111111111111111111111111111111111111
1P0000000000000000000000000000000001
10000000000000000000000000000000C001
1000000000C0000000000000E00000000001
1000000000000000C0000000000000000001
111111111111111111111111111111111111