111111111111111111
1E0001000000C00001
100000001010000001
1P0001000001000001
100C00001000000101
100010000010000001
111111111111111111