1111111111111111111111
1E00010000000000C00001
1000000011100000000001
1000100000000110000001
1C000100000000000C0101
100000000000C000000001
1P00010000011000000001
100C000010000000000101
1000100000001100000001
1111111111111111111111